1111111111111
100EC00000P01
1111111111111