111111111111111111111
10E000000000000000C01
111111101111111111111
100000000000000011111
1P0000000000C00000001
111111111111111111111